NNG	SS SE SP XPN NNG NNP SN MM SW SO SL SN
NNP	SS SE SP SW NNP SO SL SN
NNB	SS SE SP SN NR MM NNG
NP	SS SE SP
NR	SS NR SN MM NNG SW SE SP
VV	SS NNG EC MAG SE
VA	SS NNG EC SE MAG
VX	EC
VCP	NNG NNB SS XSN NR
VCN	SS JKC ETN SE JX NNG NNB
MM	SS SE SP SW NNG NR
MAG	SS SE NNG MAG SW
MAJ	SS SE
IC	SS
JKS	NNG NNB XSN
JKC	NNG ETM SE ETN NNB SH XSN JX SN NR NP SS NNP
JKG	NNG SE NR NP SS NNP
JKO	SS NNG SH NNB NNP
JKB	NNG NP NNB NNP XSN SS SH ETN SL NR
JKV	NNG NNB NNP XSN NP
JKQ	SS SP SF SE VCP
JX	NNG SS NNB XSN NP NNP JKB EC ETN SH NR MAG SL JX SW SN
JC	NNG XSN NP SS NNP ETN NNB
EP	EC NNG SS VV VX VA MAG XSV EP XSA VCP
EF	VV VX EP VA VCP XSV XSA NNG VCN NNB NP SS
EC	VV VX VA XSV EP VCP NNG XSA SS EC VCN NP NNB MAG NNP
ETN	NNG SS EC VV XSV XSA
ETM	NNG SS EC MAG VV VX VA NNB EP XSN XSV XSA
XPN	SS NNG SP SW
XSN	NNG NNB NNP SS XSN
XSV	NNG XSN SH MAG
XSA	NNG XR
XR	SS NNG XPN SP SE
SF	EC NNG NP ETM NNB EP SS XSN JX EF
SP	SS SN NNG XSN EC NNB SL NNP JX NR SW
SS	NNG SS EC NNP SF NNB SH SL SN XSN ETN JX
SE	EC SS NNG NNB MAJ JKV SL EF XSN JX NR NP IC
SO	SS NNG SN SO
SL	NNG SF NNB SH MM SN NR SP SO XPN SS SW NNP
SH	XR NNG SF SE NNB XSN SL MM SN NR SP NP SO XPN SS SW NNP
SW	SN SS NR NNG SW SL SH
NF	
NV	
SN	NNG SF ETM SE SH NNB XSN EC SL JX MM SN NR SP SO XPN JKS SS JKO SW NNP JC JKG JKB
NA	
